size 14 8
start 7 4
end 0 10

DGGGGGGGGDPPPD
DGPPPPDGDGDDPD
GGPGGGGGPPPPPG
GGPGGGDDPGDGDD
GDPGGGPPPDPPDG
DGPPPPPDDDPGDD
DGGGPGPPPPPGGG
GGGGPGGGGGGGGG
