size 14 8

start 1 12
end 5 1

endcheese

endbag

IIIIIIIIIIIIII
IIIIIIIIIIIICI
IIIIIIIIIIIICI
IIIIIIIIIIIICI
ICCCCCCCCCCCCI
IEIIIIIIIIIIII
IIIIIIIIIIIIII
IIIIIIIIIIIIII
