size 14 8

start 7 6
end 3 8

cheese 6 12
cheese 4 4
cheese 1 1
endcheese

bag 3 6
bag 1 11
bag 4 8
endbag

WWWWWWBWWWWWWW
WBBBBBBBBBBBBW
WWWWWWBWWWWWBW
WBBBBWBWEWWWBW
WBWWBWBWBBBBBW
WBWWWWBWWWWWWW
WBBBBBBBBBBBBW
WWWWWWBWWWWWWW
