size 14 8

start 3 2
end 6 13

endcheese

endbag

LLRRRRRRRLLLLL
LLLRLLLLRLLLLL
LLLRLLLLRRRRRL
LLRRRRLLLLLLRL
LLLLLRLLLLLLRL
LLLLLRLLLLLLRR
LLRRRRRRRRLLLE
LLLLLLLLRRRRLL
